s . . . . . . . . . ? . . . . . . . . x
# # # # # # . # # # . # # ! . # # . # #
. . . . . . . . . . . . . . . . . . . #
. # # # . # # # . # . # . # . # # # . #
. . . . . . . . . . . . . . . . . . . .
. # # # . # ! # # . . . # # # ! # # # .
. . . . . . . . . . . . . . . . . . . .
# # # . # # # . # # . # # . # # # . # #
. . . . . . . . . . . . . . . . . . . .
. # # # # . # # # # . # # # . # # # . .
. . . . . . . . . . . . . . . . . . . .
. # . # # . # # . # # . # . # # . # # .
. . . . . . . . . . . . . . . . . . . .
. # . # . # . ! # . . . # . # . # . # #
. . . . . . . . . . . . . . . . . . . .
. # # # . # . # # # . # . # . # # # . .
. . . . . . . . . . . . . . . . . . . .
. # # # . # # . # . # . ! # . # # . # #
. . . . . . . . . . . . . . * . . . . .
# # . # . # # # . # . # . # . # . # # #
