s . . . # . . ? . x
# # ! . # . # . # #
. . . . . . . . . #
. # # # . # # # . #
. . . . . . . . . .
. # ! # # # ! # # .
. . . . * . . . . .
# # # . # # # . # #
. . . . . . . . . .
# . # . # . # . # #
