s . . # . . . # . . . ? . . x
# # . . # # . # ! # . . # . #
. . . . . . . . . . . . . . #
. # . # # # # . # # # # . # #
. . . . . . . * . . . . . . .
. # . ! . # # # # ! . # . . .
# . . . . . . . . . . . . . #
# # . # . # # . # . # . # . #
. . . . . . . . . . . . . . .
. # # # # . # # # # . # # # .
. . . . . . . . . . . . . . .
. # # . # # # . # # # . # # .
. . . . . . . . . . . . . . .
. # . # . ! . # . . # . # . #
. . . . . . . . . . . . . . .
