. . # . . . . . . . # ? . . # . ? . . . # # # # ?
. s . . . # . ? . . . . # . . . . * . . # . # . #
. . . # . . . . . ! ? . ? ! . . . . . # . . . ? .
# # . # ? . . . . . . . ! . . . # . . # . . . # .
# . . # . # # . # . ? . . . . # . . ! ? ? . . ? .
. . . . # # . . # . . . . . . . . . . . . . # . .
. . . . . . . # . . # . ! . . # . ? . . . # . # .
# . . . . # . . . # # # . # . . . . . . . . . . .
. ? . . # . . . . ! . # . . . . . . # . . ? . . .
. . . . . . . # . ! . . . . # # . . . . # ! . . #
. # . . . . . # . . . . . . ! . . # ! . . . . # .
. ? . . . # . . . . . . # . . . . ? . # . . . . .
? . . # . . . . . . . . ? . . # . . . . # . . . .
# . . . . . . . # . ! . . . . . . . . # # . . . .
. ! # . . . . . . . . . # . . . . . . . # . . # #
. . . . . . . . . . . . # . . . . . ? . . . . . .
. . . . . . # . . . . . . . . . . . . . # . . # .
# . ? . . . ? ! . . . # # . . . . . . . # . # . .
. . . . . . . . . . # . . . . . . . ? # # . . . .
. . . . # . # ? . . . . . . . . # . . . # . . . .
# # . # . . # . . . . ? ! . . . # # . . . . . . #
. . . . # . . . . . . . . . # . . # . . # . . . .
. . . # . . . . . . # # . # . . . # . . . . . . .
. # . . # . # ! # # . # . . # # # . . ? # # # . #
. # . . . . # . . . . . # ! . . . . . . . # . . x
